###################
#    #       #    #
#O## # ##### # ##O#
#                 #
## # ### # ### # ##
   #     #     #   
## ### ##### ### ##
##       r       ##
## ### ## ## ### ##
## #   #bpy#   # ##
## #   #####   # ##
     #   O   #     
## ##### # ##### ##
##       #       ##
## ### ##### ### ##
#    #       #    #
# ##     #     ## #
# ## ### # ### ## #
#O## #   #   # ##O#
# ## # ##### # ## #
#+                #
###################
