###################
     #       #     
#### # ##### # ####
# O      #      O #
# #### # # # #### #
# #    # # #    # #
# # ## #   # ## # #
#    # ##### #    #
#### #   r   # ####
#    # ##2## #    #
# ## # #bpy# # ## #
#  #   #####   #  #
## # #   O   # # ##
## # ## ### ## # ##
##      ###      ##
## #### ### #### ##
   O #       # O   
## # # ##### # # ##
#  #     #     #  #
# ## ### # ### ## #
#+                #
###################
