###################
#                 #
# # ## ##### ## # #
# #  #   #   #  # #
# ## # # # # # ## #
       # O #       
# # ## ##### ## # #
# #  #   r   #  # #
# ## # ##3## # ## #
#  O   #bpy#      #
# ## # ##### # ## #
# ## #       # ## #
#    # ##### #  O #
### ##   #   ## ###
         #         
### #### # #### ###
#   #    O    #   #
# # # # ### # # # #
# #   #  #  #   # #
# ### ## # ## ### #
#+       #        #
###################